5 4 4 4 4 4 4 4 4 4 4 4 4 4 4 6
5 4 4 4 4 4 4 4 4 4 4 4 4 4 4 6
5 4 4 4 4 4 4 4 4 4 4 4 4 4 4 6
0 1 1 2 3 2 2 1 4 4 3 3 2 1 1 0
1 0 0 2 3 3 4 2 2 0 1 4 3 3 2 1
0 1 1 2 3 2 2 1 4 4 3 3 2 1 1 0
1 0 0 2 3 3 4 2 2 0 1 4 3 3 2 1
0 1 1 2 3 2 2 1 4 4 3 3 2 1 1 0
1 0 0 2 3 3 4 2 2 0 1 4 3 3 2 1
1 0 0 2 3 3 4 2 2 0 1 4 3 3 2 1
1 0 0 2 3 3 4 2 2 0 1 4 3 3 2 1
0 1 1 2 3 2 2 1 4 4 3 3 2 1 1 0
