0 0 0 0 0 0 0 0 0 0 0 0 0 0 0 0 0 0 0 0 0 0 12 15 15 15 15 15 15 17 0 0 0 0
0 0 0 0 0 0 0 0 0 0 0 0 0 0 0 0 0 0 0 0 0 0 14 16 16 16 16 16 16 19 0 0 0 0
0 0 0 0 0 0 0 0 0 0 0 0 0 0 0 0 0 0 0 0 0 0 14 16 16 16 16 16 16 19 0 0 0 0
0 0 0 0 0 0 0 0 0 0 0 0 0 0 0 0 0 0 0 0 0 0 10 9 9 9 9 9 9 11 0 0 0 0
0 0 0 0 0 0 0 0 0 0 0 0 0 0 0 0 0 0 0 0 0 0 10 9 9 9 9 9 9 11 0 0 0 0
0 0 0 0 0 0 0 0 0 0 0 0 0 0 0 0 0 0 0 0 0 0 10 9 9 9 9 9 9 11 0 0 0 0
0 0 0 0 0 0 0 0 0 0 0 0 0 0 0 0 0 0 0 0 0 0 4 4 10 9 9 11 4 4 0 0 0 0
0 0 0 0 0 0 0 0 0 0 0 0 0 0 0 0 0 0 0 0 0 0 3 5 10 9 9 11 5 8 0 0 0 0
12 15 15 15 15 15 15 15 15 15 15 15 15 15 15 17 0 0 12 15 15 15 15 15 10 9 9 11 15 15 15 15 15 17
14 16 16 16 16 16 16 16 16 16 16 16 16 16 16 19 0 0 14 16 16 16 16 16 10 9 9 11 16 16 16 16 16 19
14 16 16 16 16 16 16 16 16 16 16 16 16 16 16 19 0 0 14 16 16 16 16 16 10 9 9 11 16 16 16 16 16 19
10 9 9 9 9 9 9 9 9 9 9 9 9 9 9 11 0 0 10 9 9 9 9 9 9 9 9 9 9 9 9 9 9 11
10 9 9 9 9 9 9 9 9 9 9 9 9 9 9 11 0 0 10 9 9 9 9 9 9 9 9 9 9 9 9 9 9 11
10 9 9 9 9 9 9 9 9 9 9 9 9 9 9 11 0 0 10 9 9 9 9 9 9 9 9 9 9 9 9 9 9 11
10 9 9 9 9 9 9 9 9 9 9 9 9 9 9 11 0 0 10 9 9 9 9 9 9 9 9 9 9 9 9 9 9 11
10 9 9 9 9 9 9 9 9 9 9 9 9 9 9 11 0 0 10 9 9 9 9 9 9 9 9 9 9 9 9 9 9 11
10 9 9 9 9 9 9 9 9 9 9 9 9 9 9 11 0 0 10 9 9 9 9 9 9 9 9 9 9 9 9 9 9 11
4 4 4 4 4 4 10 9 9 11 4 4 4 4 4 4 0 0 4 4 4 4 10 9 9 9 9 9 9 11 4 4 4 4
3 5 5 5 5 5 23 9 9 22 5 5 5 5 5 8 0 0 3 5 5 5 10 9 9 9 9 9 9 11 5 5 5 8
0 0 0 0 0 0 23 9 9 22 0 0 0 0 0 0 0 0 0 0 0 0 10 9 9 9 9 9 9 11 0 0 0 0
0 0 0 0 0 0 23 9 9 22 0 0 0 0 0 0 0 0 0 0 0 0 10 9 9 9 9 9 9 11 0 0 0 0
0 0 0 0 0 0 23 9 9 22 0 0 0 0 0 0 0 0 0 0 0 0 5 5 19 9 9 14 5 5 0 0 0 0
0 0 0 0 0 0 23 9 9 22 0 0 0 0 0 0 0 0 0 0 0 0 0 0 23 9 9 22 0 0 0 0 0 0
0 0 0 0 0 0 23 9 9 22 0 0 0 0 0 0 0 0 0 0 0 0 0 0 23 9 9 22 0 0 0 0 0 0
0 0 0 0 0 0 23 9 9 22 0 0 0 0 0 0 0 0 0 0 0 0 0 0 23 9 9 22 0 0 0 0 0 0
12 15 15 15 15 15 20 9 9 21 15 15 15 15 15 17 0 0 12 15 15 15 15 15 20 9 9 21 15 15 15 15 15 17
14 16 16 16 16 16 16 9 9 16 16 16 16 16 16 19 0 0 14 16 16 16 16 16 16 9 9 16 16 16 16 16 16 19
14 16 16 16 16 16 16 9 9 16 16 16 16 16 16 19 0 0 14 16 16 16 16 16 16 9 9 16 16 16 16 16 16 19
10 9 9 9 9 9 9 9 9 9 9 9 9 9 9 11 0 0 10 9 9 9 9 9 9 9 9 9 9 9 9 9 9 11
10 9 9 9 9 9 9 9 9 9 9 9 9 9 9 11 15 15 10 9 9 9 9 9 9 9 9 9 9 9 9 9 9 11
10 9 9 9 9 9 9 9 9 9 9 9 9 9 9 11 16 16 10 9 9 9 9 9 9 9 9 9 9 9 9 9 9 11
9 9 9 9 9 9 9 9 9 9 9 9 9 9 9 9 9 9 9 9 9 9 9 9 9 9 9 9 9 9 9 9 9 9
10 9 9 9 9 9 9 9 9 9 9 9 9 9 9 9 9 9 9 9 9 9 9 9 9 9 9 9 9 9 9 9 9 11
10 9 9 9 9 9 9 9 9 9 9 9 9 9 9 11 15 15 10 9 9 9 9 9 9 9 9 9 9 9 9 9 9 11
10 9 9 9 9 9 9 9 9 9 9 9 9 9 9 11 0 0 10 9 9 9 9 9 9 9 9 9 9 9 9 9 9 11
4 4 4 4 4 4 2 9 9 13 4 4 4 4 4 4 0 0 4 4 4 4 4 4 2 9 9 13 4 4 4 4 4 4
3 5 5 5 5 5 19 9 9 14 5 5 5 5 5 8 0 0 3 5 5 5 5 5 19 9 9 14 5 5 5 5 5 8
0 0 0 0 0 0 23 9 9 22 0 0 0 0 0 0 0 0 0 0 0 0 0 0 23 9 9 22 0 0 0 0 0 0
0 0 0 0 0 0 23 9 9 22 0 0 0 0 0 0 0 0 0 0 0 0 0 0 23 9 9 22 0 0 0 0 0 0
0 0 0 0 0 0 23 9 9 22 0 0 0 0 0 0 0 0 0 0 0 0 0 0 23 9 9 22 0 0 0 0 0 0
12 15 15 15 15 15 20 9 9 21 15 15 15 15 15 17 0 0 12 15 15 15 15 15 20 9 9 21 15 15 15 15 15 17
14 16 16 16 16 16 16 9 9 16 16 16 16 16 16 19 0 0 14 16 16 16 16 16 16 9 9 16 16 16 16 16 16 19
14 16 16 16 16 16 16 9 9 16 16 16 16 16 16 19 0 0 14 16 16 16 16 16 16 9 9 16 16 16 16 16 16 19
10 9 9 9 9 9 9 9 9 9 9 9 9 9 9 11 0 0 10 9 9 9 9 9 9 9 9 9 9 9 9 9 9 11
10 9 9 9 9 9 9 9 9 9 9 9 9 9 9 11 0 0 10 9 9 9 9 9 9 9 9 9 9 9 9 9 9 11
10 9 9 9 9 9 9 9 9 9 9 9 9 9 9 11 0 0 10 9 9 9 9 9 9 9 9 9 9 9 9 9 9 11
10 9 9 9 9 9 9 9 9 9 9 9 9 9 9 11 0 0 10 9 9 9 9 9 9 9 9 9 9 9 9 9 9 11
10 9 9 9 9 9 9 9 9 9 9 9 9 9 9 11 0 0 10 9 9 9 9 9 9 9 9 9 9 9 9 9 9 11
10 9 9 9 9 9 9 9 9 9 9 9 9 9 9 11 0 0 10 9 9 9 9 9 9 9 9 9 9 9 9 9 9 11
10 9 9 9 9 9 9 9 9 9 9 9 9 9 9 11 0 0 10 9 9 9 9 9 9 9 9 9 9 9 9 9 9 11
4 4 4 4 4 4 4 4 4 4 4 4 4 4 4 4 0 0 4 4 4 4 4 4 4 4 4 4 4 4 4 4 4 4
3 5 5 5 5 5 5 5 5 5 5 5 5 5 5 8 0 0 3 5 5 5 5 5 5 5 5 5 5 5 5 5 5 8